30
30
22 22 22 22 22 22 22 22 22 22 22 22 22 22 22 22 22 22 22 22 22 22 22 22 22 22 22 22 22 22 
22 4  0 0  0 0  0 0  0  0 0 0 0  0  0 0  0  0 0 0  0 0  0  0 0 0  3 22 22 22
22 4  0 0  0 0  0 0  0  0 0 0 0  0  0 0  0  0 0 0  0 0  0  0 0 0  3 22 22 22
22 4 0 0  0 0  0 0  0  0 0 0 0  0  0 0  0  0 0 0  0 0  0  0 0 0  3 22 22 22
22 4 0 0  0 0  0 0  0  0 0 0 0  0  0 0  0  0 0 0  0 0  0  0 0 0  3 22 22 22
22 4 0 0  0 0  0 0  0  0 0 0 0  0  0 0  0  0 0 0  0 0  0  0 0 0  3 22 22 22
22 4 0 0  0 0  0 0  0  0 0 0 0  0  0 0  0  0 0 0  0 0  0  0 0 0  3 22 22 22
22 4 0 0  0 0  0 0  0  0 0 0 0  0  0 0  0  0 0 0  0 0  0  0 0 0  3 22 22 22
22 4 0 0  0 0  0 0  0  0 0 0 0  0  0 0  0  0 0 0  0 0  0  0 0 0  3 22 22 22
22 4 0 0  0 0  0 0  0  0 0 0 0  0  0 0  0  0 0 0  0 0  0  0 0 0 3 22 22 22
22 4 0 0  0 0  0 0  0  0 0 0 0  0  0 0  0  0 0 0  0 0  0  0 0 0  3 22 22 22
22 4 0 0  0 0  0 0  0  0 0 0 0  0  0 0  0  0 0 0  0 0  0  0 0 0 3 22 22 22
22 4 0 0  0 0  0 0  0  0 0 0 0  0  0 0  0  0 0 0  0 0  0  0 0 0  3 22 22 22
22 4 0 0  0 0  0 0  0  0 0 0 0  0  0 0  0  0 0 0  0 0  0  0 0 0  3 22 22 22
22 4 0 0  0 0  0 0  0  0 0 0 0  0  0 0  0  0 0 0  0 0  0  0 0 0  3 22 22 22
22 4 0 0  0 0  0 0  0  0 0 0 0  0  0 0  0  0 0 0  0 0  0  0 0 0  3 22 22 22
22 4 0 0  0 0  0 0  0  0 0 0 0  0  0 0  0  0 0 0  0 0  0  0 0 0  3 22 22 22
22 4 0 0  0 0  0 0  0  0 0 0 0  0  0 0  0  0 0 0  0 0  0  0 0 0  3 22 22 22
22 4 0 0  0 0  0 0  0  0 0 0 0  0  0 0  0  0 0 0  0 0  0  0 0 0  3 22 22 22
22 4 0 0  0 0  0 0  0  0 0 0 0  0  0 0  0  0 0 0  0 0  0  0 0 0  3 22 22 22
22 4 0 0  0 0  0 0  0  0 0 0 0  0  0 0  0  0 0 0  0 0  0  0 0 0  3 22 22 22
22 4 0 0  0 0  0 0  0  0 0 0 0  0  0 0  0  0 0 0  0 0  0  0 0 0  3 22 22 22
22 4 0 0  0 0  0 0  0  0 0 0 0  0  0 0  0  0 0 0  0 0  0  0 0 0  3 22 22 22
22 4 0 0  0 0  0 0  0  0 0 0 0  0  0 0  0  0 0 0  0 0  0  0 0 0  3 22 22 22 
22 4 0 0  0 0  0 0  0  0 0 0 0  0  0 0  0  0 0 0  0 0  0  0 0 0  3 22 22 22
22 4 0 0  0 0  0 0  0  0 0 0 0  0  0 0  0  0 0 0  0 0  0  0 0 0  3 22 22 22
22 4 0 0  0 0  0 0  0  0 0 0 0  0  0 0  0  0 0 0  0 0  0  0 0 0  3 22 22 22
22 4 0 0  0 0  0 0  0  0 0 0 0  0  0 0  0  0 0 0  0 0  0  0 0 0  3 22 22 22
22 4 21 21 21 21 21 21 21 21 21 22 22 22 21 21 21 21 21 21 21 21 21 21 21 21 21 22 22 22 
22 22 22 22 22 22 22 22 22 22 22 22 22 22 22 22 22 22 22 22 22 22 22 22 22 22 22 22 22 22 
